{
  "level" : {
    "name" : "First Map",
    "layout" : [
        "                    ",
        "                    ",
        "                    ",
        "                    ",
        "                    ",
        "                    ",
        "                    ",
        "  #############     ",
        "        #           ",
        "        #           ",
        "        #           ",
        "        #           ",
        "        #           ",
        "                    ",
        "                    ",
        "                    ",
        "                    ",
        "   @                ",
        "                    ",
        "                    "
    ]
  }
}